########
#......#
#..##..#
#..##..#
#......#
########
